В СЛЕДСТВИЕ (= из-за)|ВСЛЕДСТВИЕ
В ПОСЛЕДСТВИИ|ВПОСЛЕДСТВИИ
В ВИДУ (= из-за)|ВВИДУ
НА ВСТРЕЧУ (= к)|НАВСТРЕЧУ
НА ПОДОБИЕ (= вроде)|НАПОДОБИЕ
В СЛЕД (= за)|ВСЛЕД
ПО СЕРЕДИНЕ|ПОСЕРЕДИНЕ
В БЛИЗИ (= У)|ВБЛИЗИ
ПО ЗАДИ (= за)|ПОЗАДИ
В МЕСТО|ВМЕСТО
НА ПРОТИВ (= перед, у)|НАПРОТИВ
НА КАНУНЕ (= перед)|НАКАНУНЕ
В ТЕЧЕНИЕ|В ТЕЧЕНИЕ
В ПРОДОЛЖЕНИЕ|В ПРОДОЛЖЕНИЕ
НА ПРОТЯЖЕНИИ|НА ПРОТЯЖЕНИИ
В ВИДЕ (= как)|В ВИДЕ
ЗА СЧЁТ (= благодаря)|ЗА СЧЁТ
В СВЯЗИ С|В СВЯЗИ С
В ОТЛИЧИЕ ОТ|В ОТЛИЧИЕ ОТ
В ЗАКЛЮЧЕНИЕ (= под конец)|В ЗАКЛЮЧЕНИЕ
НЕ СМОТРЯ НА (= вопреки)|НЕ СМОТРЯ НА
НЕ ВЗИРАЯ НА (= вопреки)|НЕ ВЗИРАЯ НА
В СИЛУ|В СИЛУ
В ЦЕЛЯХ|В ЦЕЛЯХ
ИЗ ЗА|ИЗ-ЗА
ИЗ ПОД|ИЗ-ПОД
В ДРЕБЕЗГИ|ВДРЕБЕЗГИ
НА ТОЩАК|НАТОЩАК
ИС ПОДТИШКА|ИСПОДТИШКА
ИС ПОДЛОБЬЯ|ИСПОДЛОБЬЯ
В ДОГОНКУ|ВДОГОНКУ
ДО ТЛА|ДОТЛА
ЗА ПАНИБРАТА|ЗАПАНИБРАТА
НА СМАРКУ|НАСМАРКУ
НЕ ВПОПАД|НЕВПОПАД
ПО НАСЛЫШКЕ|ПОНАСЛЫШКЕ
С ПРОСОНЬЯ|СПРОСОНЬЯ
С ПОЗАРАНКУ|СПОЗАРАНКУ
НА СПЕХ|НАСПЕХ
НА УГАД|НАУГАД
НА ЧЕКУ|НАЧЕКУ
НЕ ВДОМЕК|НЕВДОМЕК
НЕ ВЗНАЧАЙ|НЕВЗНАЧАЙ
ПОСЛЕ ЗАВТРА|ПОСЛЕЗАВТРА
НА ВСЕГДА|НАВСЕГДА
НА СКОРО|НАСКОРО
ПОЗА ВЧЕРА|ПОЗАВЧЕРА
ОТО ВСЮДУ|ОТОВСЮДУ
ДО ЗАВТРА|ДО ЗАВТРА
НА СЕГОДНЯ|НА СЕГОДНЯ
ПОД УТРО|ПОД УТРО
ЗА ЧАСТУЮ|ЗАЧАСТУЮ
В ПУСТУЮ|ВПУСТУЮ
В ПЛОТНУЮ|ВПЛОТНУЮ
НА ПРЯМУЮ|НАПРЯМУЮ
В РУЧНУЮ|ВРУЧНУЮ
В РАССЫПНУЮ|ВРАССЫПНУЮ
В РУКОПАШНУЮ|ВРУКОПАШНУЮ
НА БОКОВУЮ|НА БОКОВУЮ
НА ПОПЯТНУЮ|НА ПОПЯТНУЮ
В ОТКРЫТУЮ|В ОТКРЫТУЮ
НА МИРОВУЮ|НА МИРОВУЮ
В ТРОЕМ|ВТРОЕМ
В СЕМЕРОМ|ВСЕМЕРОМ
НА ДВОЕ|НАДВОЕ
В ДВОЕ|ВДВОЕ
В ТРОЕ|ВТРОЕ
ПО ДВОЕ|ПО ДВОЕ
ПО ТРОЕ|ПО ТРОЕ
ПО ОДНОМУ|ПО ОДНОМУ
ПО ОДИНОЧКЕ|ПООДИНОЧКЕ
В ДОГОНКУ|ВДОГОНКУ
В СУХОМЯТКУ|ВСУХОМЯТКУ
В ПРИПРЫЖКУ|ВПРИПРЫЖКУ
В ПРИКУСКУ|ВПРИКУСКУ
В ДИКОВИНКУ|В ДИКОВИНКУ
В РАССРОЧКУ|В РАССРОЧКУ
В НАСМЕШКУ|В НАСМЕШКУ
В СЛУХ|ВСЛУХ
НА ЗЛО|НАЗЛО
ПОД ЧАС|ПОДЧАС
В ПРАВЕ|ВПРАВЕ
НА СИЛУ|НАСИЛУ
НА ПРОЛОМ|НАПРОЛОМ
НА ПЕРЕБОЙ|НАПЕРЕБОЙ
С БОКУ|СБОКУ
НА ПРОКАТ|НАПРОКАТ
НА ОТРЕЗ|НАОТРЕЗ
НА РАСПЕВ|НАРАСПЕВ
С РОДУ|СРОДУ
ПОД ЧАС|ПОДЧАС
ПО НЕВОЛЕ|ПОНЕВОЛЕ
НА УДАЧУ|НАУДАЧУ
К РЯДУ|КРЯДУ
ПО ДОЛГУ|ПОДОЛГУ
ИЗ РЕДКА|ИЗРЕДКА
ДО СЫТА|ДОСЫТА
С ЛЕВА|СЛЕВА
ПО МНОГУ|ПОМНОГУ
В ОХАПКУ|В ОХАПКУ
В ОБТЯЖКУ|В ОБТЯЖКУ
БЕЗ ОГЛЯДКИ|БЕЗ ОГЛЯДКИ
БЕЗ УДЕРЖКУ|БЕЗ УДЕРЖКУ
В УПОР|В УПОР
В ОТМЕСТКУ|В ОТМЕСТКУ
В СЕРДЦАХ|В СЕРДЦАХ
В ГОЛОВАХ|В ГОЛОВАХ
В ПОТЁМКАХ|В ПОТЁМКАХ
В ПОТЬМАХ|ВПОТЬМАХ
В ПОПЫХАХ|ВПОПЫХАХ
В ТОРОПЯХ|ВТОРОПЯХ
ДО СМЕРТИ|ДО СМЕРТИ
ДО УПАДУ|ДО УПАДУ
НА ЛЕТУ|НА ЛЕТУ
С НАЛЕТУ|С НАЛЕТУ
С ЛЕТУ|С ЛЕТУ
НА ХОДУ|НА ХОДУ
С РАЗМАХУ|С РАЗМАХУ
С РАЗБЕГУ|С РАЗБЕГУ
НА МИГ|НА МИГ
В МИГ|ВМИГ
НА СКАКУ|НА СКАКУ
НА ГЛАЗОК|НА ГЛАЗОК
ПОД СИЛУ|ПОД СИЛУ
ПОД МЫШКОЙ|ПОД МЫШКОЙ
ПО СВОЕМУ|ПО-СВОЕМУ
ПО НОВОМУ|ПО-НОВОМУ
ПО ТУРЕЦКИ|ПО-ТУРЕЦКИ
ПО ФРАНЦУЗСКИ|ПО-ФРАНЦУЗСКИ
ПО ВОЛЧЬИ|ПО-ВОЛЧЬИ
ПО ОДНОМУ|ПО ОДНОМУ
ПО ЭТОМУ (= причина)|ПОЭТОМУ
ПО ЭТОМУ (полю)|ПО ЭТОМУ
ПО НЕМНОГУ|ПОНЕМНОГУ
ПО МНОГУ|ПОМНОГУ
ПО ДОЛГУ|ПОДОЛГУ
ВО ПЕРВЫХ|ВО-ПЕРВЫХ
В ЧЕТВЕРТЫХ|В-ЧЕТВЕРТЫХ
В СОТЫХ|В-СОТЫХ
ЕЛЕ ЕЛЕ|ЕЛЕ-ЕЛЕ
ЧУТЬ ЧУТЬ|ЧУТЬ-ЧУТЬ
ТОЧЬ В-ТОЧЬ|ТОЧЬ-В-ТОЧЬ
ВОЛЕЙ НЕВОЛЕЙ|ВОЛЕЙ-НЕВОЛЕЙ
ВИДИМО НЕВИДИМО|ВИДИМО-НЕВИДИМО
ТЕТ А-ТЕТ|ТЕТ-А-ТЕТ
БОК О БОК|БОК О БОК
С ГЛАЗУ НА ГЛАЗ|С ГЛАЗУ НА ГЛАЗ
ТОЧКА В ТОЧКУ|ТОЧКА В ТОЧКУ
ВОЛК ВОЛКОМ|ВОЛК ВОЛКОМ
ЧЕСТЬ ЧЕСТЬЮ|ЧЕСТЬ ЧЕСТЬЮ
СТОЛБ СТОЛБОМ|СТОЛБ СТОЛБОМ
ЧУДАК ЧУДАКОМ|ЧУДАК ЧУДАКОМ
КРЕПКО НАКРЕПКО|КРЕПКО-НАКРЕПКО
МАЛО ПОМАЛУ|МАЛО-ПОМАЛУ
КАК НИКАК|КАК-НИКАК
НЕЖДАННО НЕГАДАННО|НЕЖДАННО-НЕГАДАННО
ПОДОБРУ ПОЗДОРОВУ|ПОДОБРУ-ПОЗДОРОВУ
ГДЕ НИБУДЬ|ГДЕ-НИБУДЬ
КОЕ КАК|КОЕ-КАК
КАК ЛИБО|КАК-ЛИБО
КУДА ТО|КУДА-ТО
НА ГОРА (выдать угол)|НА-ГОРА
ПО ЛАТЫНИ|ПО-ЛАТЫНИ
КАК БУДТО|КАК БУДТО
КАК РАЗ|КАК РАЗ
ВРЯД ЛИ|ВРЯД ЛИ
НАВРЯД ЛИ|НАВРЯД ЛИ
ВСЁ РАВНО|ВСЁ РАВНО
ПРИШЁЛ ТАКИ|ПРИШЁЛ-ТАКИ
ОПЯТЬ ТАКИ|ОПЯТЬ-ТАКИ
ВСЁ ТАКИ|ВСЁ-ТАКИ
НЕУЖЕЛИ ТАКИ|НЕУЖЕЛИ-ТАКИ
ПОЛ ТАРЕЛКИ|ПОЛТАРЕЛКИ
ПОЛ ГОРОДА|ПОЛГОРОДА
ПОЛУ ПРОВОДНИК|ПОЛУПРОВОДНИК
ПОЛУ МЕСЯЦ|ПОЛУМЕСЯЦ
ПОЛ АРБУЗА|ПОЛ-АРБУЗА
ПОЛ ЛИМОНА|ПОЛ-ЛИМОНА
ПОЛ МОСКВЫ|ПОЛ-МОСКВЫ
ПОЛ ЗЕЛЁНОГО ЯБЛОКА|ПОЛ ЗЕЛЁНОГО ЯБЛОКА
ПОЛ СТОЛОВОЙ ЛОЖКИ|ПОЛ СТОЛОВОЙ ЛОЖКИ
В ПОЛГОЛОСА|ВПОЛГОЛОСА
В ПОЛОБОРОТА|ВПОЛОБОРОТА
ЗА ГРАНИЦУ|ЗА ГРАНИЦУ
ЗА ГРАНИЦЕЙ|ЗА ГРАНИЦЕЙ